F 76,76,76
C 123,43,12

NO /Users/federico/Downloads/cub3d-2941c62a99f9118be7fd6fe19ff4219f28cd5de2/cub3d/assets/textures/east.xpm
SO /Users/federico/Downloads/cub3d-2941c62a99f9118be7fd6fe19ff4219f28cd5de2/cub3d/assets/textures/east.xpm
WE /Users/federico/Downloads/cub3d-2941c62a99f9118be7fd6fe19ff4219f28cd5de2/cub3d/assets/textures/east.xpm
EA /Users/federico/Downloads/cub3d-2941c62a99f9118be7fd6fe19ff4219f28cd5de2/cub3d/assets/textures/east.xpm

1111111111111111111
10W10010010010000011
1011000001000001001
1001001001111101111
1001111000001001001
1000000000000001001
1001111111111001001
1111000000000001011
1000000001000000001
1111111100111111111
       1111

